GGGGGGGGGG
GUUUUUUUUG
GUSSUUSSUG
GUSSUUSSUG
GUSSUUSSUG
GUSSUUSSUG
GUSSUUSSUG
GUSSUUSSUG
GUUUUUUUUG
GGGGGGGGGG